Bonjour, je m'appelle Pierre et j'adore manger des pommes.	Hi, my name is Pierre and i love eating apples.
Hier soir, j'ai pris le bus 396 pour rentrer du cin√©ma, il faisait nuit noire.	Last night, i took the bus 396 to go home from the cinema, it was dark.
Cet artiste est mon artiste pr√©f√©r√©, je l'ai d√©couvert lors d'un concert √† Las Vegas. Son album "Vanilla" est un chef d'oeuvre.	This artist is my favorite artist, i discovered him during a concert in Las Vegas. His album "Vanilla" is a masterpiece.
Voici mon adresse mail : jean.pierre@gmail,com ne me spamer pas s'il vous plait je d√©teste √ßa.	Here is my email address: jean.pierre@gmail.com Please don't spam me, I hate it.
La ps3 est la console la plus vendue pendant la p√©riode 2005-2013, la xbox 360 quant √† elle est l√©g√®rement derri√®re.	The PS3 was the best-selling console during the period 2005-2013, with the Xbox 360 slightly behind.
Oula !!! o√π tu vas comme √ßa ? J'ai failli tomber.	Whoa!!! Where are you going like that ? I almost fell.
Le maitre-nageur a dit qu'il ne fallait pas courir, tu n'en fais qu'a ta t√™te !	The lifeguard said you shouldn't run, you only do what you want !
Ce que tu m'expliques n'a ni queue, ni t√™te, tu t'es clairement fait rouler dans la farine, un peu plus et tu partais les quatre fers en l'air.	What you're telling me is completely nonsensical, you've clearly been taken for a ride, any more and you'd have been on your last legs.
Bordel ! c'est quoi √ßa ?	What the hell is this ?
Quelle heure il est chez toi ? Pour moi il est 11h37.	What time is it where you live ? Mine is 11:37.
La r√©union vient de se terminer, tu es arriv√©e trop tard.	The meeting just ended, you arrived too late.
J'ai des lumi√®res RGB derri√®re mon clavier. Mais ce que je pr√©f√®re le plus c'est mes 32Gb de ram et ma carte graphique de RTX 3070.	I have RGB lights behind my keyboard. But what I like the most is my 32GB of RAM and my RTX 3070 graphics card.
C'est l'hopital qui se fout de la charit√©.	It's the pot calling the kettle black !
Cette carte ne m√®ne nulle part !! Bon, enfin, euhh... Reprenons depuis le d√©but on va y arriver üòÉ !	This map leads nowhere!! Okay, well, uh... Let's start from the beginning, we'll get there üòÉ!
Je me demande si ils ont pens√© √† prendre leur parapluie, ils ont annonc√© de la pluie ce matin √† la m√©t√©o.	I wonder if they thought to bring their umbrella, the weather forecast said it would rain this morning.
Mon dos me fait mal, je dois prendre rdv chez mon kin√©.	My back hurts, I need to make an appointment with my physiotherapist.
Super, miam ! et cette recette de g√¢teau on la retrouve o√π ??	Great, yum! And where can we find this cake recipe?
Je suis n√© le 29 d√©cembre 2000.	I was born on December 29, 2000.
Nietzsche a surement raison dans sa vision du monde, mais je la trouve trop pessimiste pour l'admettre je pr√©f√®re la philosophie sto√Øcienne.	Nietzsche is probably right in his worldview, but I find it too pessimistic to admit it. I prefer Stoic philosophy.
Pendant mon stage, j'ai pu d√©couvrir des nouvelles approches pour aborder un probl√®me.	During my internship, I was able to discover new approaches to tackling a problem.
Il faut vraiment que je pense √† r√©sillier mon abonnement, √ßa commence √† chiffrer tout √ßa !! aie !	I really need to think about canceling my subscription, it's starting to add up !! Ouch !
Dis-moi tu en penses quoi toi de tout √ßa ?	Tell me, what do you think about all this ?
L'herbe est vraiment plus belle chez le voisin.	The grass is really nicer at the neighbor's.
J'adorerai partir avec mon sac et dos et faire le tour du monde.	I would love to go backpacking and travel the world.
La date butoire √©tait le 24/07/2025, qu'avez vous fait pendant tout ce temps ?	The deadline was 07/24/2025, what did you do during all this time ?
Le chat dort sur le canap√©.	The cat is sleeping on the couch.
Nous sommes all√©s faire les magasins aujourd'hui, il faisait chaud donc nous nous sommes arr√™t√©s pour manger une glace.	We went shopping today, it was hot so we stopped for an ice cream.
J'ai vu 6 √©toiles filantes dans le ciel cette nuit.	I saw 6 shooting stars in the sky last night.
Et soudain, il s'√©cria : " J'ai faim ! ".	And suddenly he cried out, "I‚Äôm hungry!".
As-tu vu le dernier film d'animation sorti au cin√©ma ?	Have you seen the latest animated film released in cinema?
Il a d√©pens√© 50$ pour un sandwich.	He spent $50 on a sandwich.
Il y a - 30% de r√©duction sur ce t-shirt, √ßa vaut le coup !	There is - 30% discount on this t-shirt, it‚Äôs worth it!
Il fait 23¬∞C aujourd'hui.	It‚Äôs 23¬∞C today.
On se retrouve devant la gare √† midi.	Meet me outside the station at noon.
Oh l√† l√† ! T'as encore tout cass√© ??!	Oh there! You broke everything again??!
Avoir la t√™te dans les nuages.	Having your head in the clouds.
Se faire rouler dans la farine.	Be rolled in flour.
Il a jet√© l'√©ponge.	He threw in the towel.
Chaque jour Marie va cueillir des fleurs dans son jardin.	Every day Marie goes to pick flowers in her garden.
J'ai kiff√© le resto d'hier, c'√©tait incroyable !	I loved the restaurant yesterday, it was incredible!
Il est trop relou celui-l√† √† me donner des le√ßons !!	He‚Äôs too nasty to give me lessons!
Zut, j'ai encore oubli√© mes cl√©s !	Damn, I forgot my keys again!
Pur√©e, j'ai zapp√© que j'avais un rdv ce soir...	Damn, I forgot I had a date tonight...
Elle papillonait dans la pi√®ce sans jamais rester en place.	She flashed in the room without ever standing still.
Apr√®s une longue journ√©e de travail, j'aime bien lire pour me reposer.	After a long day at work, I like to read to relax.
Je pr√©pare mes repas de la semaine en avance pour gagner du temps.	I prepare my weekly meals in advance to save time.
Mon t√©l est cass√©...je dois en racheter un nouveau.	My phone is broken...I need to buy a new one.
Quand le chat n'est pas l√†, les souris dansent.	When the cat is not there, the mice dance.
Tu m'as tu√© avec ta blague !	You killed me with your joke!
Tu veux faire quoi ce soir ?	What do you want to do tonight?
